+--+--+--+--+
|           |
+  +--+--+  +
|  |        |
+  +  +--+--+
|  |        |
+  +--+--+  +
|        |  g
+--+--+--+--+