+--+--+--+--+--+--+--+--+--+--+
|                             |
+  +--+--+--+--+  +  +--+--+  +
|  |           |  |        |  |
+  +  +--+--+  +  +--+--+  +  +
|  |        |  |           |  |
+  +--+--+  +  +--+--+--+--+  +
|        |  |  |              |
+  +--+  +  +  +  +--+--+--+--+
|  |     |  |  |  |           |
+  +  +--+  +  +  +  +--+--+  +
|  |        |  |  |        |  |
+  +--+--+--+  +  +--+--+  +  +
|              |        |  |  |
+--+--+--+--+--+  +--+  +  +  +
|                 |     |  |  |
+  +--+--+--+--+  +  +--+  +  +
|  |              |        |  |
+  +  +--+--+--+--+--+--+--+  +
|  |                          |
+  +--+--+--+--+--+--+--+--+  +
|                             g
+--+--+--+--+--+--+--+--+--+--+